|------------------------------------------------------------------------------|
|                                 ECO   REPORT                                 |
|                                                                    Page   1  |
|------------------------------------------------------------------------------|
|  C:.../CC13xx SensorTag/Manufacture/Cadence/Allegro/CC1350SensorTag.brd      |
|                                                    Wed Nov 09 12:15:27 2016  |
|------------------------------------------------------------------------------|
|------------------------------------------------------------------------------|
|   total ECO changes reported  0                                              |
|------------------------------------------------------------------------------|
